original	translated
その他	Other
アクション	Action
アドベンチャー	Adventure
アーケード	Arcade
コミュニケーション	Communication
シミュレーション	Simulation
シューティング	Shooter
ストラテジー	Strategy
スポーツ	Sports
テーブル	Board Game
トレーニング	Training
パズル	Puzzle
パーティー	Party
レース	Racing
ロールプレイング	RPG
学習	Education
実用	Utility
格闘	Fighting
音楽	Music