original	translated
Action	Action
Adventure	Adventure
Arcade	Arcade
Board Game	Board Game
Communication	Communication
Education	Education
Fighting	Fighting
First-Person Shooter	First-Person Shooter
Lifestyle	Lifestyle
Multiplayer	Multiplayer
Music	Music
Other	Other
Party	Party
Platformer	Platformer
Puzzle	Puzzle
RPG	RPG
Racing	Racing
Shooter	Shooter
Shop	Shop
Simulation	Simulation
Sports	Sports
Strategy	Strategy
Study	Study
System Tool	System Tool
Training	Training
Utility	Utility
